|--------------------------------------------------------------------------|
b           |     |                                         |     |     |  |
|--|--|--|  |  |  |--|--|--|--|--|--|--|  |--|--|--|--|--|  |  |  |--|  |  |
|           |  |                 |     |  |  |        |     |  |  |        |
|  |--|--|--|--|--|--|  |--|--|  |  |  |  |  |  |--|  |  |  |  |  |  |  |--|
|              |  |           |     |  |  |        |     |     |  |  |     |
|--|  |--|--|  |  |  |--|--|--|--|--|  |  |--|--|--|--|--|--|--|  |  |--|  |
|  |        |        |        |        |     |           |           |     |
|  |--|--|  |--|  |--|  |--|  |--|--|--|  |--|  |--|--|  |  |--|--|--|--|  |
|           |  |        |     |     |     |        |     |        |        |
|--|--|  |--|  |--|  |--|  |--|  |  |  |--|  |--|  |--|--|--|--|  |  |--|--|
|     |  |  |        |           |     |  |     |  |        |  |  |        |
|  |  |  |  |--|--|--|  |--|--|--|--|--|  |--|  |  |  |--|  |  |  |  |  |  |
|  |  |  |  |     |  |        |        |  |  |  |     |  |        |  |  |  |
|--|  |  |  |--|  |  |--|  |  |--|  |  |  |  |  |--|--|  |--|--|--|--|  |--|
|     |        |  |  |     |     |  |     |  |  |     |        |           |
|  |--|--|  |  |  |  |  |--|--|  |  |--|--|  |  |  |  |--|--|  |--|--|--|  |
|  |        |     |     |     |     |     |  |  |  |     |  |              |
|  |  |--|--|--|--|  |--|  |  |--|--|--|  |  |  |  |--|  |  |  |--|--|--|--|
|     |                    |              |        |     |                 e
|--------------------------------------------------------------------------|